Player,Team,Att,Gain,Loss,Yds,Avg,Lg,TD
Derrick Henry,ALA,395,2282,63,2219,5.62,74t,28
Christian McCaffrey,STAN,337,2065,46,2019,5.99,70t,8
Leonard Fournette,LSU,300,2045,92,1953,6.51,87t,22
Royce Freeman,ORE,283,1889,51,1838,6.49,64t,17
Ezekiel Elliott,OSU,289,1874,53,1821,6.3,80t,23
Dalvin Cook,FSU,229,1749,58,1691,7.38,94t,19
Larry Rose III,NMST,239,1719,62,1657,6.93,82,14
Donnel Pumphrey,SDSU,310,1741,85,1656,5.34,72t,17
Brian Hill,WYO,281,1681,50,1631,5.8,72t,6
Matt Breida,GSU,203,1653,50,1603,7.9,87t,17
Tyler Ervin,SJSU,294,1661,60,1601,5.45,71t,13
Alex Collins,ARK,271,1643,66,1577,5.82,80t,20
Wendell Smallwood,WVU,238,1549,30,1519,6.38,52,9
Wayne Gallman,CLEM,282,1552,38,1514,5.37,66t,13
DeAndre Washington,TTU,232,1516,21,1495,6.44,80t,14
Elijah Hood,UNC,218,1488,25,1463,6.71,67,17
Marcus Cox,APST,243,1481,53,1428,5.88,74,9
Justin Jackson,NW,312,1468,50,1418,4.54,62,5
Marlon Mack,USF,210,1418,37,1381,6.58,59,8
Keenan Reynolds,NAVY,265,1537,164,1373,5.18,67,24
Samaje Perine,OKLA,226,1375,26,1349,5.97,72t,16
James Butler,NEV,208,1379,34,1345,6.47,91,10
Paul Perkins,UCLA,237,1394,51,1343,5.67,82t,14
Mike Warren,IAST,227,1366,27,1339,5.9,76t,5
Jeremy McNichols,BSU,240,1427,90,1337,5.57,88t,20
Shock Linwood,BAY,196,1362,33,1329,6.78,79t,10
Myles Gaskin,WASH,227,1348,46,1302,5.74,86t,14
Travis Greene,BGSU,222,1323,25,1298,5.85,52,15
Jalen Hurd,TENN,277,1353,68,1285,4.64,48,12
Joel Bouagnon,NIU,283,1323,39,1284,4.54,58t,18
Aaron Green,TCU,245,1321,48,1273,5.2,86t,11
Jahad Thomas,TEM,276,1385,123,1262,4.57,60t,17
Devontae Booker,UTAH,268,1297,36,1261,4.71,62t,11
Jordan Howard,IND,196,1229,16,1213,6.19,37t,9
Tra Carson,TAMU,242,1209,44,1165,4.81,55,7
Sony Michel,UGA,219,1201,40,1161,5.3,66,8
Elijhaa Penny,IDHO,245,1173,14,1159,4.73,68,10
Ralph Webb,VAN,277,1204,52,1152,4.16,74t,5
Paul Harris,HAW,198,1176,33,1143,5.77,95t,6
Ray Lawry,ODU,194,1165,29,1136,5.86,57t,11
Ito Smith,USM,171,1156,28,1128,6.6,75t,10
Qadree Ollison,PITT,212,1158,37,1121,5.29,71t,11
Greg Ward Jr,HOU,197,1301,187,1114,5.65,47t,21
Demario Richard,AZST,210,1143,39,1104,5.26,61,7
Deshaun Watson,CLEM,206,1215,114,1101,5.34,63,12
Jalen Richard,USM,185,1113,15,1098,5.94,64t,14
Jacobi Owens,AF,206,1123,27,1096,5.32,65,7
Darius Jackson,EMU,208,1131,43,1088,5.23,63t,14
Anthony Wales,WKU,154,1093,7,1086,7.05,47t,9
Don Jackson,NEV,228,1122,43,1079,4.73,62,8
Saquon Barkley,PSU,182,1145,69,1076,5.91,56,7
Kenneth Dixon,LT,198,1144,71,1073,5.42,65t,19
Michael Gordon,ARST,168,1098,28,1070,6.37,73t,9
Jamauri Bogan,WMU,162,1080,29,1051,6.49,76t,16
Elijah McGuire,ULL,209,1083,36,1047,5.01,88t,13
Travon McMillian,VT,200,1099,56,1043,5.21,63,7
Jarveon Williams,UTSA,173,1088,49,1039,6.01,85t,8
C.J. Prosise,ND,157,1100,71,1029,6.55,91t,11
Kelvin Taylor,FLA,258,1104,76,1028,3.98,53,13
Chris Swain,NAVY,211,1038,15,1023,4.85,52t,10
Peyton Barber,AUB,237,1040,24,1016,4.29,36t,13
Devine Redding,IND,226,1075,63,1012,4.48,66t,9
Brandon Burks,TROY,201,1092,87,1005,5,92t,7
Chase Price,SDSU,189,1027,22,1005,5.32,56,6
Joseph Yearby,MIA,205,1042,40,1002,4.89,41t,6
Johnny Jefferson,BAY,136,1009,9,1000,7.35,80t,8
Quinton Flowers,USF,191,1107,116,991,5.19,67,12
Ronald Jones II,USC,153,1005,18,987,6.45,74t,8
Jordan Canzeri,IOWA,183,1029,45,984,5.38,75t,12
Kareem Hunt,TOL,178,1004,26,978,5.49,41t,12
Marquis Young,MASS,154,1017,44,973,6.32,83t,7
Kalif Phillips,CHAR,190,1028,61,967,5.09,39,5
Devante Mays,USU,165,1010,44,966,5.85,61,9
Brandon Ross,MD,150,1012,49,963,6.42,80t,10
Lamar Jackson,LOU,163,1188,228,960,5.89,73,11
Kenneth Farrow,HOU,185,975,17,958,5.18,44t,12
Xavier Johnson,USA,145,983,27,956,6.59,92t,7
Marquise Williams,UNC,158,1083,135,948,6,46,13
Terry Swanson,TOL,143,932,9,923,6.45,90,7
Conor Hundley,AKR,203,979,58,921,4.54,32t,10
Jhurell Pressley,UNM,147,967,46,921,6.27,75t,11
Marteze Waller,FRES,228,1010,90,920,4.04,64t,5
Robert Lowe,TXST,175,960,45,915,5.23,59,7
Justin Davis,USC,169,946,44,902,5.34,43,7
Markell Jones,PUR,168,882,7,875,5.21,68t,10
Dalyn Dawkins,CSU,170,910,43,867,5.1,42,2
Matt Dayes,NCST,134,883,18,865,6.46,85t,12
Stanley Williams,KY,121,924,69,855,7.07,75t,6
Teriyon Gipson,UNM,147,861,11,850,5.78,79t,6
Jeffery Wilson,UNT,154,864,25,839,5.45,43,1
Josh Adams,ND,116,869,31,838,7.22,98t,6
D'Angelo Brewer,TULS,162,854,17,837,5.17,48t,6
Anthone Taylor,BUFF,186,848,14,834,4.48,29,3
Fred Coppet,BGSU,146,846,20,826,5.66,62,5
Dare Ogunbowale,WISC,194,870,51,819,4.22,35t,7
Alfred Ramsby,GSU,165,843,27,816,4.95,46t,13
Jordan Johnson,BUFF,172,856,45,811,4.72,48,12
Thomas Sirk,DUKE,163,883,74,809,4.96,73t,8
Lamar Jordan,UNM,147,940,133,807,5.49,70t,9
Jared Baker,ARIZ,131,813,15,798,6.09,79t,9
