Player,Team,Att,Gain,Loss,Yds,Avg,Lg,TD
LaMichael James,ORE,294,1840,109,1731,5.89,--,21
Denard Robinson,MICH,256,1799,97,1702,6.65,--,14
Mikel Leshoure,ILL,281,1746,49,1697,6.04,--,17
Jordan Todman,CONN,334,1758,63,1695,5.07,--,14
Bobby Rainey,WKU,340,1711,62,1649,4.85,--,15
Vai Taua,NEV,284,1623,13,1610,5.67,--,19
Daniel Thomas,KSST,298,1615,30,1585,5.32,--,19
Lance Dunbar,UNT,274,1639,86,1553,5.67,--,13
Kendall Hunter,OKST,271,1594,46,1548,5.71,--,16
Ronnie Hillman,SDSU,262,1600,68,1532,5.85,--,17
Zach Line,SMU,244,1523,29,1494,6.12,--,10
Cam Newton,AUB,264,1662,189,1473,5.58,--,20
Chris Polk,WASH,260,1465,50,1415,5.44,--,9
Bilal Powell,LOU,229,1488,83,1405,6.14,--,11
Chad Spann,NIU,258,1429,41,1388,5.38,--,22
Knile Davis,ARK,204,1362,40,1322,6.48,--,13
Rodney Stewart,COL,290,1364,46,1318,4.54,--,10
Anthony Allen,GT,240,1346,30,1316,5.48,--,7
Doug Martin,BSU,201,1289,29,1260,6.27,--,12
Roy Helu,NEB,188,1292,47,1245,6.62,--,11
Montel Harris,BC,269,1278,35,1243,4.62,--,8
Delone Carter,SYR,231,1260,27,1233,5.34,--,9
Jay Finley,BAY,195,1245,27,1218,6.25,--,12
DeMarco Murray,OKLA,282,1253,39,1214,4.3,--,15
Colin Kaepernick,NEV,173,1309,103,1206,6.97,--,20
Edwin Baker,MSU,207,1246,45,1201,5.8,--,13
Alex Green,HAW,146,1235,36,1199,8.21,--,18
Marcus Lattimore,SCAR,249,1230,33,1197,4.81,--,17
Jacquizz Rodgers,ORST,256,1258,74,1184,4.62,--,14
Lennon Creer,LT,212,1248,67,1181,5.57,--,10
Shane Vereen,CAL,231,1225,58,1167,5.05,--,13
Dan Herron,OSU,216,1196,41,1155,5.35,--,16
Stevan Ridley,LSU,249,1187,40,1147,4.61,--,15
Stepfan Taylor,STAN,223,1175,38,1137,5.1,--,15
Cyrus Gray,TAMU,200,1180,47,1133,5.67,--,12
Robbie Rouse,FRES,205,1177,48,1129,5.51,--,8
Johnathan Franklin,UCLA,214,1193,66,1127,5.27,--,8
Adonis Thomas,TOL,175,1133,35,1098,6.27,--,8
Michael Dyer,AUB,182,1106,13,1093,6.01,--,5
Ed Wesley,TCU,166,1093,15,1078,6.49,--,11
Dion Lewis,PITT,219,1088,27,1061,4.84,--,13
James White,WISC,156,1086,34,1052,6.74,--,14
Tauren Poole,TENN,204,1085,51,1034,5.07,--,11
Asher Clark,AF,182,1081,50,1031,5.66,--,5
Isaiah Pead,CINN,157,1063,34,1029,6.55,--,6
Evan Royster,PSU,208,1042,28,1014,4.88,--,6
Jared Hassin,ARMY,191,1027,14,1013,5.3,--,9
John Clay,WISC,187,1028,16,1012,5.41,--,14
Montee Ball,WISC,163,1019,23,996,6.11,--,18
Brandon Bolden,MISS,163,1028,52,976,5.99,--,14
Vick Ballard,MSST,186,994,26,968,5.2,--,19
Ricky Dobbs,NAVY,266,1101,134,967,3.64,--,14
Taylor Martinez,NEB,162,1195,230,965,5.96,--,12
Rex Burkhead,NEB,172,990,39,951,5.53,--,7
Alexander Robinson,IAST,202,995,49,946,4.68,--,9
Adam Robinson,IOWA,203,993,52,941,4.64,--,10
Noel Devine,WVU,209,1013,77,936,4.48,--,6
Alfred Morris,FAU,227,983,55,928,4.09,--,7
Phillip Tanner,MTSU,160,978,50,928,5.8,--,13
Orleans Darkwa,TULN,184,958,33,925,5.03,--,11
Ray Graham,PITT,148,958,36,922,6.23,--,8
Thomas Merriweather,MIOH,176,967,46,921,5.23,--,12
J.J. Di Luigi,BYU,178,954,37,917,5.15,--,8
Marc Tyler,USC,171,930,17,913,5.34,--,9
Kendrick Hardy,USM,139,919,16,903,6.5,--,7
Damien Berry,MIA,190,930,31,899,4.73,--,5
Ronnie Weaver,UCF,186,946,56,890,4.78,--,11
Derrick Locke,KY,166,919,32,887,5.34,--,10
Sam McGuffie,RICE,197,947,64,883,4.48,--,6
Alex Allen,AKR,186,939,62,877,4.72,--,8
Mark Ingram,ALA,158,903,28,875,5.54,--,13
Bryce Beall,HOU,163,890,20,870,5.34,--,12
Nathan Scheelhaase,ILL,185,1048,180,868,4.69,--,5
Alexander Teich,NAVY,147,868,5,863,5.87,--,5
Darren Evans,VT,151,886,32,854,5.66,--,11
Pat Shed,UAB,157,901,54,847,5.39,--,3
John Williams,ECU,154,883,36,847,5.5,--,10
Chris Thompson,FSU,134,871,26,845,6.31,--,6
Darriet Perry,FIU,170,865,26,839,4.94,--,16
Chandler Harnish,NIU,137,946,110,836,6.1,--,7
Matt Brown,TEM,162,886,56,830,5.12,--,7
Baron Batch,TTU,177,830,14,816,4.61,--,5
Washaun Ealey,UGA,157,828,17,811,5.17,--,11
Onterio McCalebb,AUB,95,850,40,810,8.53,--,9
Allen Bradford,USC,110,821,27,794,7.22,--,5
Tim Jefferson,AF,154,868,74,794,5.16,--,15
Moise Plancher,USF,176,820,27,793,4.51,--,5
Alvester Alexander,WYO,189,908,116,792,4.19,--,14
Cameron Marshall,AZST,150,813,26,787,5.25,--,9
Derrvin Speight,USU,189,806,27,779,4.12,--,8
Alex Gillett,EMU,179,955,189,766,4.28,--,5
Jamie Harper,CLEM,197,838,78,760,3.86,--,7
Terrelle Pryor,OSU,135,898,144,754,5.59,--,4
Keith Payne,UVA,160,768,19,749,4.68,--,14
James Sims,KAN,168,749,7,742,4.42,--,9
Joshua Nesbitt,GT,166,876,139,737,4.44,--,10
Bernard Pierce,TEM,154,759,31,728,4.73,--,10
Trent Steelman,ARMY,197,841,120,721,3.66,--,11
Josh Harris,WF,126,764,44,720,5.71,--,7
Davin Meggett,MD,126,731,11,720,5.71,--,4
